NO ./north.xpm
SO ./north.xpm
WE ./south.xpm
EA ./south.xpm

F 51,51,51
C 51,34,221

11111111
10000001
10001001
10011101
10010001
10010E01
10000001
11111111
